                                
  ****             *            
     *             *            
     *             *            
     *              *            
     *          *****************
     *          *                
     *          *                
     *********  *                
        *   *  ******           
        *   *       *           
        *  **********           
        *   *         *         
        *             *         
        *****************       
                        *******0